02 02 02 02 02 02 02 02 00 00 00 00 02 02 00 00 00 00 00 00 00 02 02 02 00 00 00 00 00 00 00 00 00 00 00 00
02 02 02 02 02 02 02 02 00 00 00 00 02 02 00 00 00 00 00 00 00 02 02 02 00 00 00 00 00 00 00 00 00 00 00 00
00 00 00 00 00 02 02 02 00 00 00 00 02 02 00 00 00 00 00 00 00 02 02 02 00 00 00 00 00 00 00 00 00 00 00 00
00 00 00 00 00 02 02 02 02 02 02 02 02 02 00 00 02 02 02 02 02 02 02 02 00 00 00 00 00 00 00 00 00 00 00 00
00 00 00 00 00 02 02 02 02 02 02 02 02 02 00 00 02 02 02 02 02 02 02 02 00 00 00 00 00 00 00 00 00 00 00 00
00 00 00 00 00 02 02 02 02 02 02 02 02 02 02 02 02 02 02 02 02 02 02 02 00 00 00 00 00 00 00 00 00 00 00 00
00 00 02 02 02 02 02 02 02 02 02 02 02 02 02 02 02 02 00 00 00 00 00 00 00 00 00 00 00 00 00 00 00 00 00 00
00 00 02 02 02 02 02 02 02 02 02 02 02 02 02 02 02 02 00 00 00 00 00 00 00 00 00 00 00 00 00 00 00 00 00 00
00 00 02 02 02 02 02 02 02 02 02 02 02 02 02 02 02 02 02 02 02 02 02 02 02 02 02 02 02 02 02 02 02 02 02 02
02 02 02 02 02 02 02 02 02 02 02 02 02 02 02 02 02 02 02 02 02 02 02 02 02 02 02 02 02 02 02 02 02 02 02 02
02 02 02 02 02 02 02 02 02 02 02 02 02 02 02 02 02 02 02 02 02 02 02 02 02 02 02 02 02 02 02 02 02 02 02 02
02 02 02 02 02 02 02 02 02 02 02 02 02 02 02 02 02 02 00 00 00 00 00 00 00 00 00 00 00 00 00 00 00 00 00 00
02 02 02 02 02 02 02 02 02 02 02 02 02 02 02 02 02 02 00 00 00 00 00 00 00 00 00 00 00 00 00 00 00 00 00 00
02 02 02 00 00 02 02 02 02 02 02 02 02 02 02 02 02 02 00 00 00 00 00 00 00 00 00 00 00 00 00 00 00 00 00 00
02 02 02 00 00 02 02 02 02 02 02 02 02 02 00 00 00 00 00 00 00 00 00 00 00 00 00 00 00 00 00 00 00 00 00 00
02 02 02 00 00 00 02 02 02 00 00 02 02 02 00 00 00 00 00 00 00 00 00 00 00 00 00 00 00 00 00 00 00 00 00 00
02 02 02 00 00 00 02 02 02 00 00 02 02 02 00 00 00 00 00 00 00 00 00 00 00 00 00 00 00 00 00 00 00 00 00 00
02 02 02 00 00 00 02 02 02 00 00 02 02 02 00 00 00 00 00 00 00 00 00 00 00 00 00 00 00 00 00 00 00 00 00 00




