04 04 04 04 04 04 04 04 04 04 04
04 00 00 00 00 00 00 00 00 00 04
04 00 00 00 00 00 00 00 00 00 04
04 00 00 00 00 00 00 00 00 00 04
04 00 00 00 00 00 00 00 00 00 04 04 04 04 04 04 04 04 04
04 00 00 00 00 00 00 00 00 00 00 00 00 00 00 00 00 00 04
04 00 00 00 00 00 00 00 00 00 00 00 00 00 00 00 00 00 04
04 00 00 00 00 00 00 00 00 00 00 00 00 00 00 00 00 00 04
04 00 00 00 00 00 00 00 00 04 04 04 04 04 04 04 04 04 04
04 00 00 00 00 00 00 00 00 04
04 00 00 00 00 00 00 00 00 04
04 00 00 00 00 00 00 00 00 04
04 00 00 00 00 00 00 00 00 04 04 04 04 04
04 00 00 00 00 00 00 00 00 00 00 00 00 04
04 00 00 00 00 00 00 00 00 00 00 00 00 04
04 00 00 00 00 00 00 00 00 04 04 04 04 04
04 00 00 00 00 00 00 00 00 04
04 00 00 00 00 00 00 00 00 04
04 00 00 00 00 00 00 00 00 04
04 04 04 04 04 04 04 04 04 04
