04 04 04 04 04 04 04 04 05 00 00 00 00 00 00 00 00 00 00 00 00 05 04 05 00 00 00 00 00 00 00 00 00 00 00 00
00 00 00 00 00 00 00 00 05 00 00 00 00 00 00 00 00 00 00 00 00 05 00 05 00 00 00 00 00 00 00 00 00 00 00 00
04 04 04 04 04 05 00 00 05 00 00 00 00 00 00 00 00 00 00 00 00 05 00 05 00 00 00 00 00 00 00 00 00 00 00 00
00 00 00 00 00 05 00 00 05 00 00 00 00 00 00 00 04 04 04 04 04 05 00 05 00 00 00 00 00 00 00 00 00 00 00 00
00 00 00 00 00 05 00 00 00 00 00 00 00 00 00 00 00 00 00 00 00 00 00 05 00 00 00 00 00 00 00 00 00 00 00 00
00 00 00 00 00 05 00 00 00 00 00 00 00 00 00 00 00 05 04 04 04 04 04 05 00 00 00 00 00 00 00 00 00 00 00 00
00 00 05 04 04 05 00 00 00 00 00 00 00 00 00 00 00 05 00 00 00 00 00 00 00 00 00 00 00 00 00 00 00 00 00 00
00 00 05 00 00 00 00 00 00 00 00 00 00 00 00 00 00 05 00 00 00 00 00 00 00 00 00 00 00 00 00 00 00 00 00 00
00 00 05 00 00 00 00 00 00 00 00 00 00 00 00 00 00 04 04 04 04 04 04 04 04 04 04 04 04 04 04 04 04 04 04 04
05 04 05 00 00 00 00 00 00 00 00 00 00 00 00 00 00 00 00 00 00 00 00 00 00 00 00 00 00 00 00 00 00 00 00 00
05 00 00 00 00 00 00 00 00 00 00 00 00 00 00 00 00 04 04 04 04 04 04 04 04 04 04 04 04 04 04 04 04 04 04 04
05 00 00 00 00 00 00 00 00 00 00 00 00 00 00 00 00 05 00 00 00 00 00 00 00 00 00 00 00 00 00 00 00 00 00 00
05 00 05 05 05 04 00 00 00 00 00 00 00 00 00 00 00 05 00 00 00 00 00 00 00 00 00 00 00 00 00 00 00 00 00 00
05 00 05 00 00 04 00 00 00 00 00 00 00 04 04 04 04 05 00 00 00 00 00 00 00 00 00 00 00 00 00 00 00 00 00 00
05 00 05 00 00 04 05 00 05 04 04 05 00 05 00 00 00 00 00 00 00 00 00 00 00 00 00 00 00 00 00 00 00 00 00 00
05 00 05 00 00 00 05 00 05 00 00 05 00 05 00 00 00 00 00 00 00 00 00 00 00 00 00 00 00 00 00 00 00 00 00 00
05 00 05 00 00 00 05 00 05 00 00 05 00 05 00 00 00 00 00 00 00 00 00 00 00 00 00 00 00 00 00 00 00 00 00 00
05 04 05 00 00 00 05 00 05 00 00 05 00 05 00 00 00 00 00 00 00 00 00 00 00 00 00 00 00 00 00 00 00 00 00 00
